16 9 4
level0.png-0
level1.png-1
level4.png-4
level2.png-2
......0...4.....
...#....#...#...
.#..............
................
..............#.
1...............
................
.#............#.
.....#.22.#....